%%%%%%%%%%%%%%%%
%P             %
% .% .    .% . %
%  %       %   %
% .% .    .% . %
%             G%
%%%%%%%%%%%%%%%%
