%%%%%%%
% P...%
% %%%.%
% %...%
% %%% %
%. G  %
%%%%%%%
